
->cron(‘* * * * *’);	                Run the task on a custom Cron schedule
->everyMinute();	                Run the task every minute
->everyTwoMinutes();	                Run the task every two minutes
->everyThreeMinutes();	                Run the task every three minutes
->everyFourMinutes();	                Run the task every four minutes
->everyFiveMinutes();	                Run the task every five minutes
->everyTenMinutes();	                Run the task every ten minutes
->everyFifteenMinutes();	                Run the task every fifteen minutes
->everyThirtyMinutes();	                Run the task every thirty minutes
->hourly();	                Run the task every hour
->hourlyAt(17);	                Run the task every hour at 17 minutes past the hour
->everyTwoHours();	                Run the task every two hours
->everyThreeHours();	                Run the task every three hours
->everyFourHours();	                Run the task every four hours
->everySixHours();	                Run the task every six hours
->daily();	                Run the task every day at midnight
->dailyAt(’13:00′);	                Run the task every day at 13:00
->twiceDaily(1, 13);	                Run the task daily at 1:00 & 13:00
->weekly();	                Run the task every sunday at 00:00
->weeklyOn(1, ‘8:00’);	                Run the task every week on Monday at 8:00
->monthly();	                Run the task on the first day of every month at 00:00
->monthlyOn(4, ’15:00′);	                Run the task every month on the 4th at 15:00
->monthlyOnLastDay(’15:00′);	                Run the task on the last day of the month at 15:00
->quarterly();	                Run the task on the first day of every quarter at 00:00
->yearly();	                    Run the task on the first day of every year at 00:00
->timezone(‘America/New_York’);	Set the timezone
 